#######
#.#...#
#.O...#
#..O..#
#...O@#
#.....#
#######
